1 14 14
  100   100     12    12    13    13    0     0     0     0     0     0     0     0 
  100   100     12    12    13    13    0     0     0     0     0     0     0     0 
    0     0     0     0     0     0     0     0     0     0     0     0     0     0 
   10    10     0     0     0     0     0     0     0     0     0     0     0     0 
   10    10     0     0     0     0     0     0     0     0     0     0     0     0 
    0     0     0     0     0     0     0     0     0     0     0     0     0     0 
   11    11     0     0     0     0     0     0     0     0     0     0   -11   -11 
   11    11     0     0     0     0     0     0     0     0     0     0   -11   -11 
    0     0     0     0     0     0     0     0     0     0     0     0     0     0 
    0     0     0     0     0     0     0     0     0     0     0     0   -10   -10 
    0     0     0     0     0     0     0     0     0     0     0     0   -10   -10 
    0     0     0     0     0     0     0     0     0     0     0     0     0     0 
    0     0     0     0     0     0   -13   -13     0   -12   -12     0  -100  -100 
    0     0     0     0     0     0   -13   -13     0   -12   -12     0  -100  -100

10
50 2 50
25 3 25
100 1 100