1 30	31
0    0    0    0    0    0  0   0    0    0    0    0    0    0    0    0    0    0    0    0    0    0    0    0    0    0    0    0    0     0    0
0    0    0    0    0    0  0   0    0    0    0    0    0    0    0    0    0    0    0    0    0    0    0    0    0    0    0    0    0     0    0
0    0    0    0    0    0  0   0    0    0    0    0    0    0    0    0    0    0    0    0    0    0    0    0    0    0    0    0    0     0    0
10   10    0    0    0    0  0   0    0    0    0    0    0    1    1    1    1    1    0    0    0    0    0    0    0    0    0    0    0   -13  -13
10   10    0    0    0    0  0   0    0    0    0    0    0    0    0    0    1    0    0    0    0    0    0    0    0    0    0    0    0   -13  -13
0    0    0    0    0    0  0   0    0    0    0    0    0    0    0    1    0    0    0    0    0    0    0    0    0    0    0    0    0     0    0
0    0    0    0    0    0  0   0    0    0    0    0    0    0    1    0    0    0    0    0    0    0    0    0    0    0    0    0    0     0    0
0    0    0    0    0    0  0   0    0    0    0    0    0    1    1    1    1    1    0    0    0    0    0    0    0    0    0    0    0     0    0
0    0    0    0    0    0  0   0    0    0    0    0    0    0    0    0    0    0    0    0    0    0    0    0    0    0    0    0    0     0    0
11   11    0    0    0    0  0   0    0    0    0    0    0    0    0    0    0    0    0    0    0    0    0    0    0    0    0    0    0   -12  -12
11   11    0    0    0    0  0   0    0    0    0    0    0    1    1    1    1    1    0    0    0    0    0    0    0    0    0    0    0   -12  -12
0    0    0    0    0    0  0   0    0    0    0    0    0    1    0    1    0    1    0    0    0    0    0    0    0    0    0    0    0     0    0
0    0    0    0    0    0  0   0    0    0    0    0    0    1    0    1    0    1    0    0    0    0    0    0    0    0    0    0    0     0    0
0    0    0    0    0    0  0   0    0    0    0    0    0    1    0    1    0    1    0    0    0    0    0    0    0    0    0    0    0     0    0
100  100    2    0    0    0  0   0    0    0    0    0    0    0    0    0    0    0    0    0    0    0    0    0    0    0    0    0    2  -100 -100
100  100    2    0    0    0  0   0    0    0    0    0    0    0    0    0    0    0    0    0    0    0    0    0    0    0    0    0    2  -100 -100
0    0    0    0    0    0  0   0    0    0    0    0    0    1    0    1    1    1    0    0    0    0    0    0    0    0    0    0    0     0    0
0    0    0    0    0    0  0   0    0    0    0    0    0    1    0    1    0    1    0    0    0    0    0    0    0    0    0    0    0     0    0
0    0    0    0    0    0  0   0    0    0    0    0    0    1    0    1    0    1    0    0    0    0    0    0    0    0    0    0    0     0    0
12   12    0    0    0    0  0   0    0    0    0    0    0    1    1    1    0    1    0    0    0    0    0    0    0    0    0    0    0    -11   -11
12   12    0    0    0    0  0   0    0    0    0    0    0    0    0    0    0    0    0    0    0    0    0    0    0    0    0    0    0    -11  -11
0    0    0    0    0    0  0   0    0    0    0    0    0    0    0    0    0    0    0    0    0    0    0    0    0    0    0    0    0     0    0
0    0    0    0    0    0  0   0    0    0    0    0    0    0    0    1    0    0    0    0    0    0    0    0    0    0    0    0    0     0    0    
0    0    0    0    0    0  0   0    0    0    0    0    0    0    0    1    0    0    0    0    0    0    0    0    0    0    0    0    0     0    0    
0    0    0    0    0    0  0   0    0    0    0    0    0    1    1    1    1    1    0    0    0    0    0    0    0    0    0    0    0     0    0  
13   13    0    0    0    0  0   0    0    0    0    0    0    0    0    1    0    0    0    0    0    0    0    0    0    0    0    0    0    -10  -10  
13   13    0    0    0    0  0   0    0    0    0    0    0    0    0    1    0    0    0    0    0    0    0    0    0    0    0    0    0    -10  -10  
0    0    0    0    0    0  0   0    0    0    0    0    0    0    0    0    0    0    0    0    0    0    0    0    0    0    0    0    0     0    0
0    0    0    0    0    0  0   0    0    0    0    0    0    0    0    0    0    0    0    0    0    0    0    0    0    0    0    0    0     0    0  
0    0    0    0    0    0  0   0    0    0    0    0    0    0    0    0    0    0    0    0    0    0    0    0    0    0    0    0    0     0    0  
100
50 2 50
25 3 25
100 1 100