4 40	40
    0    0    0    0    0    0    0    0    0    0    0    0    0    1    1    0    0    0    0    0    0    0    0    0    0    2    2    0    0    0    0    0    0    0    0    0    0    0    0    0
    0    0    0    0    0    0    0    0    0    0    0    0    0    1    1    0    0    0    0    0    0    0    0    0    0    2    2    0    0    0    0    0    0    0    0    0    0    0    0    0
    0    0    0    0    0    0    0    0    0    0    0    0    0    1    1    0    0    0    0    0    0    0    0    0    0    2    2    0    0    0    0    0    0    0    0    0    0    0    0    0
    0    0    0    0    0    0    0    0    0    0    0    0    0    1    1    0    0    0    0    0    0    0    0    0    0    2    2    0    0    0    0    0    0    0    0    0    0    0    0    0
    0    0    0    0    0    0    0    1    1    0    0    0    0    1    1    0    0    0    0    3    3    0    0    0    0    2    2    0    0    0    0    2    2    0    0    0    0    0    0    0
    0    0    0    0    0    0    0    1    1    0    0    0    0    1    1    0    0    0    0    3    3    0    0    0    0    2    2    0    0    0    0    2    2    0    0    0    0    0    0    0
   10   10    0    0    0    0    0    1    1    0    0    0    0    1    1    0    0    0    0    3    3    0    0    0    0    2    2    0    0    0    0    2    2    0    0    0    0    0  -13  -13
   10   10    0    0    0    0    0    1    1    0    0    0    0    1    1    0    0    0    0    3    3    0    0    0    0    2    2    0    0    0    0    2    2    0    0    0    0    0  -13  -13
    0    0    0    0    0    0    0    1    1    0    0    0    0    1    1    0    0    0    0    3    3    0    0    0    0    2    2    0    0    0    0    2    2    0    0    0    0    0    0    0
    0    0    0    0    0    0    0    1    1    0    0    0    0    1    1    0    0    0    0    3    3    0    0    0    0    2    2    0    0    0    0    2    2    0    0    0    0    0    0    0
    0    0    0    0    0    0    0    1    1    0    0    0    0    1    1    0    0    0    0    3    3    0    0    0    0    2    2    0    0    0    0    2    2    0    0    0    0    0    0    0
    0    0    0    0    0    0    0    1    1    0    0    0    0    1    1    0    0    0    0    3    3    0    0    0    0    2    2    0    0    0    0    2    2    0    0    0    0    0    0    0
    0    0    0    0    0    0    0    1    1    0    0    0    0    1    1    0    0    0    0    3    3    0    0    0    0    2    2    0    0    0    0    2    2    0    0    0    0    0    0    0
   11   11    0    0    0    0    0    1    1    0    0    0    0    1    1    0    0    0    0    3    3    0    0    0    0    2    2    0    0    0    0    2    2    0    0    0    0    0  -12  -12
   11   11    0    0    0    0    0    1    1    0    0    0    0    1    1    0    0    0    0    3    3    0    0    0    0    2    2    0    0    0    0    2    2    0    0    0    0    0  -12  -12
    0    0    0    0    0    0    0    1    1    0    0    0    0    0    0    0    0    0    0    3    3    0    0    0    0    0    0    0    0    0    0    2    2    0    0    0    0    0    0    0
    0    0    0    0    0    0    0    1    1    0    0    0    0    0    0    0    0    3    3    3    3    3    3    0    0    0    0    0    0    0    0    2    2    0    0    0    0    0    0    0
    0    0    0    0    0    0    0    1    1    0    0    0    0    0    0    0    0    1    0    0    0    0    3    0    0    0    0    0    0    0    0    2    2    0    0    0    0    0    0    0
    0    0    0    0    0    0    0    1    1    0    0    0    0    0    0    0    0    1    0    0    0    0    3    0    0    0    0    0    0    0    0    2    2    0    0    0    0    0    0    0
  100  100    1    1    1    1    1    1    1    1    1    1    1    1    1    1    1    3    0    0    0    0    3    2    2    2    2    2    2    2    2    2    2    2    2    2    2    2 -100 -100
  100  100    2    2    2    2    2    2    2    2    2    2    2    2    2    2    2    3    0    0    0    0    3    1    1    1    1    1    1    1    1    1    1    1    1    1    1    1 -100 -100
    0    0    0    0    0    0    0    2    2    0    0    0    0    0    0    0    0    3    0    0    0    0    1    0    0    0    0    0    0    0    0    1    1    0    0    0    0    0    0    0
    0    0    0    0    0    0    0    2    2    0    0    0    0    0    0    0    0    3    0    0    0    0    1    0    0    0    0    0    0    0    0    1    1    0    0    0    0    0    0    0
    0    0    0    0    0    0    0    2    2    0    0    0    0    0    0    0    0    3    3    3    3    3    3    0    0    0    0    0    0    0    0    1    1    0    0    0    0    0    0    0
    0    0    0    0    0    0    0    2    2    0    0    0    0    0    0    0    0    0    0    3    3    0    0    0    0    0    0    0    0    0    0    1    1    0    0    0    0    0    0    0
   12   12    0    0    0    0    0    2    2    0    0    0    0    2    2    0    0    0    0    3    3    0    0    0    0    1    1    0    0    0    0    1    1    0    0    0    0    0  -11  -11
   12   12    0    0    0    0    0    2    2    0    0    0    0    2    2    0    0    0    0    3    3    0    0    0    0    1    1    0    0    0    0    1    1    0    0    0    0    0  -11  -11
    0    0    0    0    0    0    0    2    2    0    0    0    0    2    2    0    0    0    0    3    3    0    0    0    0    1    1    0    0    0    0    1    1    0    0    0    0    0    0    0
    0    0    0    0    0    0    0    2    2    0    0    0    0    2    2    0    0    0    0    3    3    0    0    0    0    1    1    0    0    0    0    1    1    0    0    0    0    0    0    0
    0    0    0    0    0    0    0    2    2    0    0    0    0    2    2    0    0    0    0    3    3    0    0    0    0    1    1    0    0    0    0    1    1    0    0    0    0    0    0    0
    0    0    0    0    0    0    0    2    2    0    0    0    0    2    2    0    0    0    0    3    3    0    0    0    0    1    1    0    0    0    0    1    1    0    0    0    0    0    0    0
    0    0    0    0    0    0    0    2    2    0    0    0    0    2    2    0    0    0    0    3    3    0    0    0    0    1    1    0    0    0    0    1    1    0    0    0    0    0    0    0
   13   13    0    0    0    0    0    2    2    0    0    0    0    2    2    0    0    0    0    3    3    0    0    0    0    1    1    0    0    0    0    1    1    0    0    0    0    0  -10  -10
   13   13    0    0    0    0    0    2    2    0    0    0    0    2    2    0    0    0    0    3    3    0    0    0    0    1    1    0    0    0    0    1    1    0    0    0    0    0  -10  -10
    0    0    0    0    0    0    0    2    2    0    0    0    0    2    2    0    0    0    0    3    3    0    0    0    0    1    1    0    0    0    0    1    1    0    0    0    0    0    0    0
    0    0    0    0    0    0    0    0    0    0    0    0    0    2    2    0    0    0    0    0    0    0    0    0    0    1    1    0    0    0    0    0    0    0    0    0    0    0    0    0
    0    0    0    0    0    0    0    0    0    0    0    0    0    2    2    0    0    0    0    0    0    0    0    0    0    1    1    0    0    0    0    0    0    0    0    0    0    0    0    0
    0    0    0    0    0    0    0    0    0    0    0    0    0    2    2    0    0    0    0    0    0    0    0    0    0    1    1    0    0    0    0    0    0    0    0    0    0    0    0    0
    0    0    0    0    0    0    0    0    0    0    0    0    0    2    2    0    0    0    0    0    0    0    0    0    0    1    1    0    0    0    0    0    0    0    0    0    0    0    0    0
    0    0    0    0    0    0    0    0    0    0    0    0    0    2    2    0    0    0    0    0    0    0    0    0    0    1    1    0    0    0    0    0    0    0    0    0    0    0    0    0
150
50 2 50
25 3 25
100 1 100