4 40	40
1    1    1    1    1    1    1    0    0    0    0    0    0    2    2    0    0    0    0    1    1    0    0    0    0    2    2    0    0    0    0    0    0    1    1    1    1    1    1   1
1    1    1    1    1    1    1    0    0    0    0    0    0    2    2    0    0    0    0    1    1    0    0    0    0    2    2    0    0    0    0    0    0    1    1    1    1    1    1   1
1    1    1    1    1    1    1    2    2    2    2    0    0    2    2    0    0    0    0    1    1    0    0    0    0    2    2    0    0    2    2    2    2    1    1    1    1    1    1   1
1    1    1    1    1    1    1    2    2    2    2    0    0    2    2    0    0    0    0    1    1    0    0    0    0    2    2    0    0    2    2    2    2    1    1    1    1    1    1   1
1    1    1    1    1    1    1    2    2    0    0    0    0    2    2    0    0    0    0    3    3    0    0    0    0    2    2    0    0    0    0    2    2    1    1    1    1    1    1   1
1    1    1    1    1    1    1    2    2    0    0    0    0    2    2    0    0    0    0    3    3    0    0    0    0    2    2    0    0    0    0    2    2    1    1    1    1    1    1   1
10   10   1    1    1    1    1    2    2    0    0    2    2    2    2    0    0    0    0    3    3    0    0    0    0    2    2    2    2    0    0    2    2    1    1    1    1    1  -13  -13
10   10   1    1    1    1    1    2    2    0    0    2    2    2    2    0    0    0    0    3    3    0    0    0    0    2    2    2    2    0    0    2    2    1    1    1    1    1  -13  -13
1    1    1    1    1    1    1    2    2    0    0    0    0    2    2    0    0    0    0    3    3    0    0    0    0    2    2    0    0    0    0    2    2    1    1    1    1    1    1   1
1    1    1    1    1    1    1    2    2    0    0    0    0    2    2    0    0    0    0    3    3    0    0    0    0    2    2    0    0    0    0    2    2    1    1    1    1    1    1   1
1    1    1    1    1    1    1    2    2    2    2    0    0    2    2    0    0    0    0    3    3    0    0    0    0    2    2    0    0    2    2    2    2    1    1    1    1    1    1   1
1    1    1    1    1    1    1    2    2    2    2    0    0    2    2    0    0    0    0    3    3    0    0    0    0    2    2    0    0    2    2    2    2    1    1    1    1    1    1   1
1    1    1    1    1    1    1    2    2    0    0    0    0    2    2    0    0    0    0    3    3    0    0    0    0    2    2    0    0    0    0    2    2    1    1    1    1    1    1   1
11   11   1    1    1    1    1    2    2    0    0    0    0    2    2    0    0    0    0    3    3    0    0    0    0    2    2    0    0    0    0    2    2    1    1    1    1    1  -12  -12
11   11   1    1    1    1    1    2    2    0    0    0    0    2    2    0    0    0    0    3    3    0    0    0    0    2    2    0    0    0    0    2    2    1    1    1    1    1  -12  -12
1    1    1    1    1    1    1    2    2    0    0    2    2    2    2    0    0    0    0    3    3    0    0    0    0    2    2    2    2    0    0    2    2    1    1    1    1    1    1   1
1    1    1    1    1    1    1    2    2    0    0    2    2    2    2    1    1    3    3    3    3    3    3    1    1    2    2    2    2    0    0    2    2    1    1    1    1    1    1   1
1    1    1    1    1    1    1    2    2    0    0    1    1    1    1    1    1    1    1    0    0    3    3    1    1    1    1    1    1    0    0    2    2    1    1    1    1    1    1   1
1    1    1    1    1    1    1    2    2    0    0    1    1    1    1    1    1    1    1    0    0    3    3    1    1    1    1    1    1    0    0    2    2    1    1    1    1    1    1   1
100  100  2    2    2    2    2    2    2    2    2    2    2    2    2    2    2    3    3    0    0    3    3    2    2    2    2    2    2    2    2    2    2    2    2    2    2    2 -100 -100
100  100  2    2    2    2    2    2    2    2    2    2    2    2    2    2    2    3    3    0    0    3    3    2    2    2    2    2    2    2    2    2    2    2    2    2    2    2 -100 -100
1    1    1    1    1    1    1    2    2    0    0    1    1    1    1    1    1    3    3    0    0    1    1    1    1    1    1    1    1    0    0    2    2    1    1    1    1    1    1   1
1    1    1    1    1    1    1    2    2    0    0    1    1    1    1    1    1    3    3    0    0    1    1    1    1    1    1    1    1    0    0    2    2    1    1    1    1    1    1   1
1    1    1    1    1    1    1    2    2    0    0    2    2    2    2    1    1    3    3    3    3    3    3    1    1    2    2    2    2    0    0    2    2    1    1    1    1    1    1   1
1    1    1    1    1    1    1    2    2    0    0    2    2    2    2    0    0    0    0    3    3    0    0    0    0    2    2    2    2    0    0    2    2    1    1    1    1    1    1   1
12   12   1    1    1    1    1    2    2    0    0    0    0    2    2    0    0    0    0    3    3    0    0    0    0    2    2    0    0    0    0    2    2    1    1    1    1    1  -11  -11
12   12   1    1    1    1    1    2    2    0    0    0    0    2    2    0    0    0    0    3    3    0    0    0    0    2    2    0    0    0    0    2    2    1    1    1    1    1  -11  -11
1    1    1    1    1    1    1    2    2    0    0    0    0    2    2    0    0    0    0    3    3    0    0    0    0    2    2    0    0    0    0    2    2    1    1    1    1    1    1   1
1    1    1    1    1    1    1    2    2    2    2    0    0    2    2    0    0    0    0    3    3    0    0    0    0    2    2    0    0    2    2    2    2    1    1    1    1    1    1   1
1    1    1    1    1    1    1    2    2    2    2    0    0    2    2    0    0    0    0    3    3    0    0    0    0    2    2    0    0    2    2    2    2    1    1    1    1    1    1   1
1    1    1    1    1    1    1    2    2    0    0    0    0    2    2    0    0    0    0    3    3    0    0    0    0    2    2    0    0    0    0    2    2    1    1    1    1    1    1   1
1    1    1    1    1    1    1    2    2    0    0    0    0    2    2    0    0    0    0    3    3    0    0    0    0    2    2    0    0    0    0    2    2    1    1    1    1    1    1   1
13   13   1    1    1    1    1    2    2    0    0    2    2    2    2    0    0    0    0    3    3    0    0    0    0    2    2    2    2    0    0    2    2    1    1    1    1    1  -10  -10
13   13   1    1    1    1    1    2    2    0    0    2    2    2    2    0    0    0    0    3    3    0    0    0    0    2    2    2    2    0    0    2    2    1    1    1    1    1  -10  -10
1    1    1    1    1    1    1    2    2    0    0    0    0    2    2    0    0    0    0    3    3    0    0    0    0    2    2    0    0    0    0    2    2    1    1    1    1    1    1   1
1    1    1    1    1    1    1    2    2    0    0    0    0    2    2    0    0    0    0    1    1    0    0    0    0    2    2    0    0    0    0    2    2    1    1    1    1    1    1   1
1    1    1    1    1    1    1    2    2    2    2    0    0    2    2    0    0    0    0    1    1    0    0    0    0    2    2    0    0    2    2    2    2    1    1    1    1    1    1   1
1    1    1    1    1    1    1    2    2    2    2    0    0    2    2    0    0    0    0    1    1    0    0    0    0    2    2    0    0    2    2    2    2    1    1    1    1    1    1   1
1    1    1    1    1    1    1    0    0    0    0    0    0    2    2    0    0    0    0    1    1    0    0    0    0    2    2    0    0    0    0    0    0    1    1    1    1    1    1   1
1    1    1    1    1    1    1    0    0    0    0    0    0    2    2    0    0    0    0    1    1    0    0    0    0    2    2    0    0    0    0    0    0    1    1    1    1    1    1   1
250
50 2 50
25 3 25
100 1 100